"filename", "language", "CSS", "JavaScript", "JSON", "XML", "comment", "blank", "total"
"d:\individual-track-repo\individual-track\Frontend\individual_track_react\src\App.css", "CSS", 21, 0, 0, 0, 0, 6, 27
"d:\individual-track-repo\individual-track\Frontend\individual_track_react\src\App.js", "JavaScript", 0, 59, 0, 0, 1, 13, 73
"d:\individual-track-repo\individual-track\Frontend\individual_track_react\src\App.test.js", "JavaScript", 0, 7, 0, 0, 0, 2, 9
"d:\individual-track-repo\individual-track\Frontend\individual_track_react\src\Components\AllUsers.css", "CSS", 6, 0, 0, 0, 0, 1, 7
"d:\individual-track-repo\individual-track\Frontend\individual_track_react\src\Components\AllUsers.js", "JavaScript", 0, 4, 0, 0, 30, 2, 36
"d:\individual-track-repo\individual-track\Frontend\individual_track_react\src\Components\AvailablePlace.css", "CSS", 32, 0, 0, 0, 0, 13, 45
"d:\individual-track-repo\individual-track\Frontend\individual_track_react\src\Components\AvailablePlace.js", "JavaScript", 0, 23, 0, 0, 0, 6, 29
"d:\individual-track-repo\individual-track\Frontend\individual_track_react\src\Components\FilterByAddress.css", "CSS", 3, 0, 0, 0, 0, 0, 3
"d:\individual-track-repo\individual-track\Frontend\individual_track_react\src\Components\FilterByAddress.js", "JavaScript", 0, 9, 0, 0, 0, 3, 12
"d:\individual-track-repo\individual-track\Frontend\individual_track_react\src\Components\FilterByPrice.css", "CSS", 3, 0, 0, 0, 0, 1, 4
"d:\individual-track-repo\individual-track\Frontend\individual_track_react\src\Components\FilterByPrice.js", "JavaScript", 0, 16, 0, 0, 0, 3, 19
"d:\individual-track-repo\individual-track\Frontend\individual_track_react\src\Components\Footer.css", "CSS", 10, 0, 0, 0, 0, 2, 12
"d:\individual-track-repo\individual-track\Frontend\individual_track_react\src\Components\Footer.js", "JavaScript", 0, 11, 0, 0, 0, 4, 15
"d:\individual-track-repo\individual-track\Frontend\individual_track_react\src\Components\ModalUpdateAccInfo.css", "CSS", 0, 0, 0, 0, 0, 1, 1
"d:\individual-track-repo\individual-track\Frontend\individual_track_react\src\Components\ModalUpdateAccInfo.js", "JavaScript", 0, 8, 0, 0, 0, 4, 12
"d:\individual-track-repo\individual-track\Frontend\individual_track_react\src\Components\Navbar.css", "CSS", 116, 0, 0, 0, 0, 12, 128
"d:\individual-track-repo\individual-track\Frontend\individual_track_react\src\Components\Navbar.js", "JavaScript", 0, 116, 0, 0, 0, 5, 121
"d:\individual-track-repo\individual-track\Frontend\individual_track_react\src\Components\Reservations.css", "CSS", 52, 0, 0, 0, 0, 11, 63
"d:\individual-track-repo\individual-track\Frontend\individual_track_react\src\Components\Reservations.js", "JavaScript", 0, 53, 0, 0, 0, 11, 64
"d:\individual-track-repo\individual-track\Frontend\individual_track_react\src\Components\UserById.css", "CSS", 0, 0, 0, 0, 0, 1, 1
"d:\individual-track-repo\individual-track\Frontend\individual_track_react\src\Components\UserById.js", "JavaScript", 0, 0, 0, 0, 0, 1, 1
"d:\individual-track-repo\individual-track\Frontend\individual_track_react\src\FakeData\FakeHouses.js", "JavaScript", 0, 87, 0, 0, 0, 3, 90
"d:\individual-track-repo\individual-track\Frontend\individual_track_react\src\Pages\APNotLoggedIn.css", "CSS", 12, 0, 0, 0, 0, 3, 15
"d:\individual-track-repo\individual-track\Frontend\individual_track_react\src\Pages\APNotLoggedIn.js", "JavaScript", 0, 18, 0, 0, 0, 6, 24
"d:\individual-track-repo\individual-track\Frontend\individual_track_react\src\Pages\AboutUs.css", "CSS", 98, 0, 0, 0, 0, 18, 116
"d:\individual-track-repo\individual-track\Frontend\individual_track_react\src\Pages\AboutUs.js", "JavaScript", 0, 41, 0, 0, 0, 7, 48
"d:\individual-track-repo\individual-track\Frontend\individual_track_react\src\Pages\AvailablePlaces.css", "CSS", 72, 0, 0, 0, 1, 14, 87
"d:\individual-track-repo\individual-track\Frontend\individual_track_react\src\Pages\AvailablePlaces.js", "JavaScript", 0, 76, 0, 0, 0, 19, 95
"d:\individual-track-repo\individual-track\Frontend\individual_track_react\src\Pages\Blog.css", "CSS", 6, 0, 0, 0, 0, 2, 8
"d:\individual-track-repo\individual-track\Frontend\individual_track_react\src\Pages\BookingInformation.css", "CSS", 66, 0, 0, 0, 0, 19, 85
"d:\individual-track-repo\individual-track\Frontend\individual_track_react\src\Pages\BookingInformation.js", "JavaScript", 0, 64, 0, 0, 0, 11, 75
"d:\individual-track-repo\individual-track\Frontend\individual_track_react\src\Pages\Home.css", "CSS", 28, 0, 0, 0, 0, 5, 33
"d:\individual-track-repo\individual-track\Frontend\individual_track_react\src\Pages\Home.js", "JavaScript", 0, 14, 0, 0, 0, 3, 17
"d:\individual-track-repo\individual-track\Frontend\individual_track_react\src\Pages\HouseInformation.css", "CSS", 126, 0, 0, 0, 0, 23, 149
"d:\individual-track-repo\individual-track\Frontend\individual_track_react\src\Pages\HouseInformation.js", "JavaScript", 0, 71, 0, 0, 0, 20, 91
"d:\individual-track-repo\individual-track\Frontend\individual_track_react\src\Pages\LogIn.css", "CSS", 97, 0, 0, 0, 0, 20, 117
"d:\individual-track-repo\individual-track\Frontend\individual_track_react\src\Pages\LogIn.js", "JavaScript", 0, 82, 0, 0, 4, 31, 117
"d:\individual-track-repo\individual-track\Frontend\individual_track_react\src\Pages\LogOut.js", "JavaScript", 0, 17, 0, 0, 0, 7, 24
"d:\individual-track-repo\individual-track\Frontend\individual_track_react\src\Pages\Profile.css", "CSS", 50, 0, 0, 0, 0, 11, 61
"d:\individual-track-repo\individual-track\Frontend\individual_track_react\src\Pages\Profile.js", "JavaScript", 0, 28, 0, 0, 0, 11, 39
"d:\individual-track-repo\individual-track\Frontend\individual_track_react\src\Pages\SignUp.css", "CSS", 32, 0, 0, 0, 0, 7, 39
"d:\individual-track-repo\individual-track\Frontend\individual_track_react\src\Pages\SignUp.js", "JavaScript", 0, 62, 0, 0, 0, 18, 80
"d:\individual-track-repo\individual-track\Frontend\individual_track_react\src\index.css", "CSS", 12, 0, 0, 0, 0, 2, 14
"d:\individual-track-repo\individual-track\Frontend\individual_track_react\src\index.js", "JavaScript", 0, 12, 0, 0, 3, 3, 18
"d:\individual-track-repo\individual-track\Frontend\individual_track_react\src\logo.svg", "XML", 0, 0, 0, 1, 0, 0, 1
"d:\individual-track-repo\individual-track\Frontend\individual_track_react\src\package-lock.json", "JSON", 0, 0, 3, 0, 0, 1, 4
"d:\individual-track-repo\individual-track\Frontend\individual_track_react\src\reportWebVitals.js", "JavaScript", 0, 12, 0, 0, 0, 2, 14
"d:\individual-track-repo\individual-track\Frontend\individual_track_react\src\setupTests.js", "JavaScript", 0, 1, 0, 0, 4, 1, 6
"Total", "-", 842, 891, 3, 1, 43, 369, 2149